12 22
up.lvl left.lvl right.lvl down.lvl
00 00 00 00 00 00 00 00 00 00 00 00 00 00 00 00 00 00 00 00 00 00
00 00 00 00 00 00 00 00 00 00 00 00 00 00 00 00 00 00 00 00 00 00
00 00 00 00 00 00 01 00 00 00 00 00 00 01 00 00 00 00 00 00 00 00
00 00 00 00 00 00 00 00 00 00 00 00 00 00 00 00 00 00 00 00 00 00
00 00 00 01 00 00 00 00 00 00 00 00 00 01 00 00 00 00 00 00 00 00
00 00 00 00 00 00 00 00 00 00 00 00 00 00 00 00 00 00 00 00 00 00
01 01 01 01 01 01 01 01 01 01 00 01 01 01 01 01 01 01 01 01 01 01
01 01 01 01 01 01 01 01 01 01 00 00 01 01 01 01 01 01 01 01 01 01
01 01 01 01 01 01 01 01 01 01 01 00 01 01 01 01 01 01 01 01 01 01
01 01 01 01 01 01 01 01 01 01 01 00 00 01 01 01 01 01 01 01 01 01
01 01 01 01 01 01 01 01 01 01 01 00 00 01 01 01 01 01 01 01 01 01
01 01 01 01 01 01 01 01 01 01 01 00 00 01 01 01 01 01 01 01 01 01