24 48
00 00 00 00 00 00 00 00 00 00 00 00 00 00 00 00 00 00 00 00 00 00 00 00 00 00 00 00 00 00 00 00 00 00 00 00 00 00 00 00 00 00 00 00 00 00 00 00
00 00 00 00 00 00 00 00 00 00 00 00 00 00 00 00 00 00 00 00 00 00 00 00 00 00 00 00 00 00 00 00 00 00 00 00 00 00 00 00 00 00 00 00 00 00 00 00
00 00 00 00 00 00 00 00 00 00 00 00 00 00 00 00 00 00 00 00 00 00 00 00 00 00 00 00 00 00 00 00 00 00 00 00 00 00 00 00 00 00 00 00 00 00 00 00
00 00 00 00 00 00 00 00 00 00 00 00 00 00 00 00 00 00 00 00 00 00 00 00 00 00 00 00 00 00 00 00 00 00 00 00 00 00 00 00 00 00 00 00 00 00 00 00
00 00 00 00 00 00 00 00 00 00 00 00 00 00 00 00 00 00 00 00 00 00 00 00 00 00 00 00 00 00 00 00 00 00 00 00 00 00 00 00 00 00 00 00 00 00 00 00
00 00 00 02 02 02 00 00 00 00 00 00 00 00 00 02 02 02 00 00 00 00 00 00 00 00 00 02 02 02 00 00 00 00 00 00 00 00 00 02 02 02 00 00 00 00 00 00
00 00 02 01 01 01 02 02 02 02 02 02 00 00 02 01 01 01 02 02 02 02 02 02 00 00 02 01 01 01 02 02 02 02 02 02 00 00 02 01 01 01 02 02 02 02 02 02
02 02 01 01 01 01 01 01 01 01 01 01 02 02 01 01 01 01 01 01 01 01 01 01 02 02 01 01 01 01 01 01 01 01 01 01 02 02 01 01 01 01 01 01 01 01 01 01
01 01 01 01 02 02 02 02 01 01 01 01 01 01 01 01 02 02 02 02 01 01 01 01 01 01 01 01 02 02 02 02 01 01 01 01 01 01 01 01 02 02 02 02 01 01 01 01
02 02 02 02 00 00 00 00 02 01 01 01 02 02 02 02 00 00 00 00 02 01 01 01 02 02 02 02 00 00 00 00 02 01 01 01 02 02 02 02 00 00 00 00 02 01 01 01
00 00 00 00 00 00 00 00 00 02 02 01 00 00 00 00 00 00 00 00 00 02 02 01 00 00 00 00 00 00 00 00 00 02 02 01 00 00 00 00 00 00 00 00 00 02 02 01
00 00 00 00 00 00 00 00 00 00 00 02 00 00 00 00 00 00 00 00 00 00 00 02 00 00 00 00 00 00 00 00 00 00 00 02 00 00 00 00 00 00 00 00 00 00 00 02 
00 00 00 00 00 00 00 00 00 00 00 00 00 00 00 00 00 00 00 00 00 00 00 00 00 00 00 00 00 00 00 00 00 00 00 00 00 00 00 00 00 00 00 00 00 00 00 00
00 00 00 00 00 00 00 00 00 00 00 00 00 00 00 00 00 00 00 00 00 00 00 00 00 00 00 00 00 00 00 00 00 00 00 00 00 00 00 00 00 00 00 00 00 00 00 00
00 00 00 00 00 00 00 00 00 00 00 00 00 00 00 00 00 00 00 00 00 00 00 00 00 00 00 00 00 00 00 00 00 00 00 00 00 00 00 00 00 00 00 00 00 00 00 00
00 00 00 00 00 00 00 00 00 00 00 00 00 00 00 00 00 00 00 00 00 00 00 00 00 00 00 00 00 00 00 00 00 00 00 00 00 00 00 00 00 00 00 00 00 00 00 00
00 00 00 00 00 00 00 00 00 00 00 00 00 00 00 00 00 00 00 00 00 00 00 00 00 00 00 00 00 00 00 00 00 00 00 00 00 00 00 00 00 00 00 00 00 00 00 00
00 00 00 02 02 02 00 00 00 00 00 00 00 00 00 02 02 02 00 00 00 00 00 00 00 00 00 02 02 02 00 00 00 00 00 00 00 00 00 02 02 02 00 00 00 00 00 00
00 00 02 01 01 01 02 02 02 02 02 02 00 00 02 01 01 01 02 02 02 02 02 02 00 00 02 01 01 01 02 02 02 02 02 02 00 00 02 01 01 01 02 02 02 02 02 02
02 02 01 01 01 01 01 01 01 01 01 01 02 02 01 01 01 01 01 01 01 01 01 01 02 02 01 01 01 01 01 01 01 01 01 01 02 02 01 01 01 01 01 01 01 01 01 01
01 01 01 01 02 02 02 02 01 01 01 01 01 01 01 01 02 02 02 02 01 01 01 01 01 01 01 01 02 02 02 02 01 01 01 01 01 01 01 01 02 02 02 02 01 01 01 01
02 02 02 02 00 00 00 00 02 01 01 01 02 02 02 02 00 00 00 00 02 01 01 01 02 02 02 02 00 00 00 00 02 01 01 01 02 02 02 02 00 00 00 00 02 01 01 01
00 00 00 00 00 00 00 00 00 02 02 01 00 00 00 00 00 00 00 00 00 02 02 01 00 00 00 00 00 00 00 00 00 02 02 01 00 00 00 00 00 00 00 00 00 02 02 01
00 00 00 00 00 00 00 00 00 00 00 02 00 00 00 00 00 00 00 00 00 00 00 02 00 00 00 00 00 00 00 00 00 00 00 02 00 00 00 00 00 00 00 00 00 00 00 02 