12 22
00 06 06 06 06 00 00 00 00 00 00 00 00 00 00 00 00 00 00 00 00 00 
00 00 00 00 00 00 00 00 00 00 00 00 00 00 00 00 00 00 00 00 00 00 
00 00 00 20 20 20 20 20 20 20 20 20 20 20 00 00 00 00 00 00 00 00 
00 00 00 00 00 00 00 00 00 00 00 00 00 00 00 00 00 00 00 00 00 00 
00 00 00 02 02 02 02 02 02 02 02 02 02 02 00 00 00 00 00 00 00 00
00 00 00 02 02 02 02 02 02 02 02 02 02 02 00 00 00 00 00 00 00 00 
00 00 00 02 02 16 12 12 12 12 12 17 02 02 00 00 00 00 00 00 00 00 
00 00 00 02 02 15 01 01 01 01 01 13 02 02 00 00 00 00 00 00 00 00 
00 00 00 02 02 15 01 01 01 01 01 13 02 02 00 00 00 00 00 00 00 00 
00 00 00 02 02 19 14 14 14 14 14 18 02 02 00 00 00 00 00 00 00 00 
00 00 00 02 02 02 02 02 02 02 02 02 02 02 00 00 00 00 00 00 00 00 
00 00 00 02 02 02 02 02 02 02 02 02 02 02 00 00 00 00 00 00 00 00 
